400000000000000000000000000000
400000000000000000000000000000
400000000000000000000000000000
400000000000000000000000000000
440000000000000000000000000000
044400000000000000000000000000
000444440444044044000000000000
000000000000000000440000000000
000000000000000000040000000000
000000000000000004440000000000
000000000000000044000000000000
000000000000000000000000000000
000000000000000000000000000000
000000000000000000000000000000
000000000000000000000000000000
