111111111111111111111111111111
1#4448888848888080008668888661
144444484448000088088668668661
144444484448000080808668668661
144444484448888080808668888661
144444484448000080008668668661
144444484448000080008668668661
144444484448888080008668668661
144444444440000000000666666661
144448444448888800800686666661
144448444448000800080866666661
144448444448000800008666666661
144448444448000800080866666661
1444488884488888008006866666$1
111111111111101111111111111111
