#14242424202020220000000000000
414242424202020220000000000000
414242424202020220000000000000
414242444000000020000000000000
414244424222202000000000000000
414442424202202020000000000000
414242424202202020000000000000
414242424202202020000000000000
424242424202202020000000000000
424242424202202020000000000000
424242424202202020000000000000
424242424202202020000000000000
424242224202202020000000000000
422244424202202220000000000000
44444222420000000000000000000$
