211212222212212211122122121221
255148888888888888888888862771
155441818282818281828282866772
255148888888888888888888861772
252242828282818281828181862271
155248888888888888888888862771
155242828181828281818281862772
1#52488888888888888888888627$1
255242828182828181828281861771
255248888888888888888888861772
152242828181828182818281861172
255148888888888888888888862771
255442828182818182828182861771
255148888888888888888888862771
112122222222122222221121121211
