111111111111111111111111111111
1#0000010000000100000000100001
111111010111110101111110111101
100000010100000000000010000001
101111010101111101011011111101
101000010101000001000000000001
101011110100010101011010110101
100010000001000101000010100101
111010110101111101111110101101
101010110100000000100000000001
101010110101111110111101011101
101000000100000010000001010001
101111101111111010111101010101
1000000000000000100000000000$1
111111111111111111111111111111
