111111111111111111111111111111
1#5422222200000000000006666761
145424400002220202020202226761
145422222222020202020206666761
145424400000020202020202226761
145422222222020202020006666761
145444400000080202022022226761
145555522222020202000027777761
144444480000020202222086666661
145555520222020200000027777761
145444400002020222222026666761
145422222222020000000022226761
145424400000022222222222226761
1454242222220000000000066667$1
111111111111111111111111111111
