222222222222222222222222222222
2#1080002200080100000002020002
241020200002020102022200000202
241020222011020002000202220202
244000200012000022010202080002
211110201080012008010002020222
200000202020220022080200020002
202220202020000200020202022202
200020002080220022020202000002
222020200010800210080102011112
200080202010220000210002000662
202022202000100010110222020162
202000002220101010200002020162
2000202000000010800022000801$2
222222222222222222222222222222
