222222222222222222222222222222
2#4444444333333333333333333332
222222222322222222223222222232
255555552300200002003277777772
252222222322201102223222222272
252333333322201102223333333272
252222222300800008003222222272
255555552322201102223277777772
252222222300800008003222222272
252333333322201102223333333272
252222222300201102003222222272
255555552322200002223277777772
232222222300222222003222222222
2333333333280000008236666666$2
222222222222222222222222222222
